{
	wrong_info : "informations incorrectes",
	username : "nom d'utilisateur",
	password : "mot de passe",
	settings : "Options",
	back : "Retour",
	select : "Selectionner",
	play : "Jouer",
	assessment : "Évaluation",
	upload : "Envoyer",
	name : "Nom",
	dominant_member : "dominant member",
	hemiplegia : "hemiplegia",
	previous : "Précédent",
	start : "Commencer",
	next : "Suivant",
	gems : "Gemmes",
	gem : "Gemme",
	new_level : "Nouveau niveau !",
	level : "niveau",
	score : "Score",
	duration : "Durée",
	locked : "Verrouillé",
	not_found : "inconnue",
	found : "trouvée",
	resume : "Reprendre",
	quit : "Quitter",
	range : "range",
	workspace_width : "largeur du plan de travail",
	workspace_height : "hauteur de plan de travail",
	path_delta_time : "path delta time",
	evaporation_per_day : "evaporation par jour",
	alpha : "alpha",
	number_of_lines : "Nombre de lignes",
	number_of_rows : "Nombre de colonnes",
	total_volume : "Volume total",
	volume_per_level : "Volume par niveau",
	delete : "Supprimer",
	save: "Sauvegarder",
	discard: "Oublier"
}
